TIME-TRIAL
111111111111
m000m00000m1
m000m00000m1
m0011e1100m1
m001e11100m1
1e111111e111
1111ee111111
111m000m1111
11m0m0m0m111
11m0m0m0m111
100w0001w00w
