CLASSIC
11111111111
101100001101
101111111101
100000000001
101111e11101
1000m00m0001
101100001101
10m00110m011
110011e10011
0e0011110m00
100w0001w00w

