DODGE-BALL
111111111111
m0m00000m00m
m0m00000m00m
1111e1e1e111
m0m0m111m0m1
111e1e1111e1
w1111000111w
111000000011
110000000001
111100000011
11w11w11w111
10m01110m011